10x5
s11111111112
...........3
g.dBCF11...3
....*......3
o.t.l.b....3
.c.p.D.m.S.4